%%%%%%%%%%%%%%%%%%%%%%
%S                   %
%  %%%               %
%  G                 %
%%%%%%%%%%%%%%%%%%%%%%
